//MAP CONVERTED BY dmm2tgm.py THIS HEADER COMMENT PREVENTS RECONVERSION, DO NOT REMOVE
"aC" = (
/obj/machinery/cryopod{
	dir = 8
	},
/turf/open/floor/plating,
/area/ship/crew)
"cs" = (
/turf/open/floor/plasteel/mono,
/area/ship/cargo)
"dC" = (
/obj/machinery/power/apc/auto_name/directional/east,
/obj/structure/cable{
	icon_state = "0-2"
	},
/obj/machinery/atmospherics/components/unary/vent_pump/high_volume/on/layer2,
/turf/open/floor/plasteel/mono,
/area/ship/cargo)
"dT" = (
/obj/machinery/atmospherics/components/unary/vent_scrubber/on/layer4{
	dir = 4
	},
/obj/structure/cable{
	icon_state = "4-8"
	},
/turf/open/floor/plasteel/mono,
/area/ship/cargo)
"em" = (
/obj/structure/chair/comfy/shuttle{
	dir = 4
	},
/obj/machinery/button/door{
	id = "truckwindows";
	name = "Window Lockdown";
	pixel_x = -20;
	pixel_y = 8;
	dir = 4
	},
/obj/machinery/atmospherics/components/unary/vent_scrubber/on/layer4,
/obj/item/radio/intercom/wideband/directional/west{
	pixel_y = -7
	},
/obj/machinery/atmospherics/pipe/simple/supply/hidden/layer2,
/turf/open/floor/plasteel/dark,
/area/ship/bridge)
"eZ" = (
/obj/machinery/atmospherics/components/binary/pump/on/layer2{
	dir = 8
	},
/turf/open/floor/plating,
/area/ship/crew)
"fb" = (
/obj/machinery/light_switch{
	dir = 4;
	pixel_x = -20;
	pixel_y = -19
	},
/obj/machinery/light_switch{
	dir = 4;
	pixel_x = -20;
	pixel_y = -19
	},
/obj/machinery/atmospherics/pipe/simple/scrubbers/hidden/layer4{
	dir = 4
	},
/obj/structure/cable{
	icon_state = "4-8"
	},
/obj/structure/cable{
	icon_state = "2-4"
	},
/obj/machinery/atmospherics/pipe/manifold4w/supply/hidden/layer2,
/turf/open/floor/plasteel/grimy,
/area/ship/crew)
"fi" = (
/obj/docking_port/stationary{
	width = 15;
	height = 30;
	dwidth = 15
	},
/turf/template_noop,
/area/template_noop)
"gF" = (
/obj/machinery/power/terminal{
	dir = 8
	},
/obj/machinery/button/door{
	dir = 1;
	id = "truckthrustsouth";
	name = "Thruster Lockdown";
	pixel_y = -21
	},
/obj/structure/cable{
	icon_state = "0-1"
	},
/turf/open/floor/plating,
/area/ship/crew)
"jJ" = (
/turf/closed/wall/r_wall/yesdiag,
/area/ship/bridge)
"ky" = (
/obj/structure/cable{
	icon_state = "1-2"
	},
/obj/machinery/atmospherics/pipe/manifold/supply/hidden/layer2{
	dir = 8
	},
/obj/machinery/atmospherics/pipe/simple/scrubbers/hidden/layer4,
/turf/open/floor/plasteel/grimy,
/area/ship/crew)
"kB" = (
/turf/closed/wall/r_wall,
/area/ship/crew)
"kC" = (
/obj/structure/grille,
/obj/structure/window/reinforced/fulltile,
/obj/machinery/door/poddoor{
	dir = 4;
	id = "truckwindows"
	},
/turf/open/floor/plating,
/area/ship/bridge)
"kD" = (
/obj/machinery/door/poddoor{
	dir = 4;
	id = "loadback"
	},
/obj/structure/cable{
	icon_state = "1-4"
	},
/obj/structure/cable{
	icon_state = "0-4"
	},
/obj/machinery/power/shieldwallgen/atmos{
	dir = 1;
	id = "loadfield";
	anchored = 1
	},
/turf/open/floor/plasteel/mono,
/area/ship/cargo)
"lq" = (
/obj/structure/cable{
	icon_state = "0-4"
	},
/obj/machinery/power/shuttle/engine/electric,
/turf/open/floor/engine/hull,
/area/ship/crew)
"lI" = (
/obj/structure/closet/crate{
	name = "fuel crate";
	desc = "A rectangular steel crate. This one has some fuel supplies in it."
	},
/obj/item/stack/sheet/mineral/plasma/ten,
/turf/open/floor/plasteel/mono,
/area/ship/cargo)
"lS" = (
/turf/closed/wall/r_wall,
/area/ship/engineering/engines/port)
"mp" = (
/obj/structure/sign/warning/docking,
/turf/closed/wall/r_wall/yesdiag,
/area/ship/engineering/engines/port)
"mX" = (
/obj/machinery/power/terminal{
	dir = 8
	},
/obj/structure/cable/yellow{
	icon_state = "0-9"
	},
/obj/machinery/atmospherics/pipe/simple/supply/hidden/layer2{
	dir = 6
	},
/turf/open/floor/plasteel/grimy,
/area/ship/crew)
"na" = (
/obj/structure/chair/comfy/shuttle{
	dir = 4
	},
/obj/machinery/light/directional/west,
/obj/machinery/atmospherics/pipe/simple/scrubbers/hidden/layer4,
/obj/machinery/atmospherics/components/unary/vent_pump/high_volume/on/layer2{
	dir = 1
	},
/turf/open/floor/plasteel/dark,
/area/ship/bridge)
"no" = (
/obj/machinery/atmospherics/pipe/simple/supply/hidden/layer2{
	dir = 6
	},
/turf/open/floor/plasteel/grimy,
/area/ship/crew)
"pP" = (
/obj/machinery/atmospherics/pipe/simple/supply/hidden/layer2{
	dir = 5
	},
/obj/structure/cable{
	icon_state = "1-4"
	},
/obj/machinery/light_switch{
	dir = 1;
	pixel_x = -12;
	pixel_y = -19
	},
/obj/structure/cable{
	icon_state = "4-8"
	},
/obj/machinery/atmospherics/pipe/simple/scrubbers/hidden/layer4{
	dir = 4
	},
/turf/open/floor/plasteel/mono,
/area/ship/cargo)
"qq" = (
/obj/structure/window/reinforced/fulltile,
/obj/machinery/door/poddoor{
	dir = 4;
	id = "truckwindows"
	},
/obj/structure/grille,
/turf/open/floor/plating,
/area/ship/bridge)
"qN" = (
/turf/closed/wall,
/area/ship/cargo)
"rP" = (
/obj/structure/bed{
	dir = 8;
	pixel_y = 0
	},
/obj/item/bedsheet/brown,
/turf/open/floor/plasteel/grimy,
/area/ship/crew)
"sf" = (
/obj/structure/closet/crate{
	desc = "A rectangular steel crate. This one has basic mining gear in it.";
	name = "basic mining crate"
	},
/obj/item/storage/bag/ore,
/obj/item/pickaxe,
/obj/item/mining_scanner,
/turf/open/floor/plasteel/mono,
/area/ship/cargo)
"sE" = (
/obj/structure/toilet{
	pixel_y = 18;
	dir = 2
	},
/obj/machinery/door/window{
	dir = 4
	},
/obj/structure/sink{
	pixel_y = 1;
	dir = 1
	},
/obj/machinery/door/window{
	dir = 8
	},
/obj/machinery/atmospherics/pipe/simple/supply/hidden/layer2{
	dir = 8
	},
/turf/open/floor/plasteel/grimy,
/area/ship/crew)
"uK" = (
/obj/structure/cable{
	icon_state = "4-8"
	},
/turf/open/floor/plasteel/mono,
/area/ship/cargo)
"vk" = (
/obj/structure/cable{
	icon_state = "2-9"
	},
/obj/effect/turf_decal/industrial/warning/fulltile,
/obj/machinery/atmospherics/pipe/simple/supply/hidden/layer2,
/obj/machinery/door/airlock/external/glass,
/obj/machinery/atmospherics/pipe/simple/scrubbers/hidden/layer4,
/turf/open/floor/plasteel/patterned,
/area/ship/engineering/engines/port)
"vE" = (
/obj/machinery/atmospherics/components/unary/tank/air{
	dir = 8;
	piping_layer = 2
	},
/turf/open/floor/plating,
/area/ship/crew)
"vR" = (
/obj/machinery/power/shuttle/engine/electric,
/obj/structure/cable{
	icon_state = "0-4"
	},
/turf/open/floor/engine/hull,
/area/ship/engineering/engines/port)
"vV" = (
/obj/machinery/button/door{
	pixel_y = 19;
	pixel_x = -6;
	id = "loadback"
	},
/obj/machinery/button/shieldwallgen{
	pixel_y = 18;
	pixel_x = 3;
	id = "loadfield"
	},
/obj/effect/turf_decal/industrial/warning{
	dir = 8
	},
/turf/open/floor/plasteel/mono,
/area/ship/cargo)
"xa" = (
/turf/closed/wall/r_wall/yesdiag,
/area/ship/engineering/engines/port)
"xA" = (
/obj/machinery/power/port_gen/pacman{
	anchored = 1
	},
/obj/structure/cable/yellow{
	icon_state = "0-6"
	},
/turf/open/floor/plasteel/grimy,
/area/ship/crew)
"yc" = (
/obj/machinery/power/terminal{
	dir = 8
	},
/obj/structure/cable{
	icon_state = "0-4"
	},
/obj/machinery/button/door{
	id = "truckthrustnorth";
	name = "Thruster Lockdown";
	pixel_y = 21
	},
/obj/machinery/power/apc/auto_name/directional/south,
/turf/open/floor/plating,
/area/ship/engineering/engines/port)
"yK" = (
/obj/machinery/power/apc/auto_name/directional/west,
/obj/structure/cable{
	icon_state = "0-1"
	},
/obj/machinery/power/apc/auto_name/directional/west,
/obj/structure/cable{
	icon_state = "1-2"
	},
/obj/machinery/atmospherics/pipe/simple/supply/hidden/layer2{
	dir = 5
	},
/turf/open/floor/plating,
/area/ship/crew)
"yL" = (
/obj/machinery/power/smes/shuttle,
/obj/machinery/door/poddoor{
	dir = 4;
	id = "truckthrustsouth"
	},
/obj/structure/window/reinforced{
	dir = 8
	},
/obj/structure/cable{
	icon_state = "0-8"
	},
/turf/open/floor/plating,
/area/ship/crew)
"Bm" = (
/obj/machinery/power/smes/shuttle,
/obj/machinery/door/poddoor{
	dir = 4;
	id = "truckthrustnorth"
	},
/obj/structure/window/reinforced{
	dir = 8
	},
/obj/structure/cable{
	icon_state = "0-8"
	},
/turf/open/floor/plating,
/area/ship/engineering/engines/port)
"Cc" = (
/obj/machinery/light/dim/directional/south,
/obj/structure/cable{
	icon_state = "4-8"
	},
/turf/open/floor/plasteel/mono,
/area/ship/cargo)
"Cq" = (
/obj/structure/grille,
/obj/machinery/door/poddoor{
	id = "truckwindows";
	dir = 4
	},
/obj/structure/window/reinforced/fulltile,
/turf/open/floor/plating,
/area/ship/bridge)
"EJ" = (
/obj/machinery/autolathe,
/turf/open/floor/plasteel/mono,
/area/ship/cargo)
"FE" = (
/obj/machinery/atmospherics/pipe/simple/supply/hidden/layer2{
	dir = 8
	},
/obj/machinery/door/airlock/command{
	dir = 4;
	name = "Bridge";
	req_access_txt = "19"
	},
/obj/structure/cable{
	icon_state = "4-8"
	},
/obj/machinery/atmospherics/pipe/simple/scrubbers/hidden/layer4{
	dir = 4
	},
/turf/open/floor/plasteel/grimy,
/area/ship/crew)
"FT" = (
/turf/closed/wall/r_wall/yesdiag,
/area/ship/cargo)
"GV" = (
/obj/effect/turf_decal/industrial/warning/fulltile,
/obj/machinery/door/airlock/external,
/obj/effect/mapping_helpers/airlock/locked,
/turf/open/floor/plasteel/dark,
/area/ship/engineering/engines/port)
"HJ" = (
/obj/machinery/light/dim/directional/north,
/turf/open/floor/plasteel/mono,
/area/ship/cargo)
"Iu" = (
/obj/structure/cable{
	icon_state = "4-8"
	},
/obj/machinery/atmospherics/pipe/manifold/scrubbers/hidden/layer4,
/turf/open/floor/plasteel/grimy,
/area/ship/crew)
"Jd" = (
/obj/structure/cable{
	icon_state = "4-8"
	},
/obj/effect/turf_decal/industrial/warning{
	dir = 8
	},
/turf/open/floor/plasteel/mono,
/area/ship/cargo)
"JE" = (
/obj/machinery/holopad,
/obj/machinery/power/apc/auto_name/directional/south,
/obj/structure/cable{
	icon_state = "0-8"
	},
/obj/machinery/light_switch{
	dir = 1;
	pixel_x = -12;
	pixel_y = -19
	},
/obj/machinery/atmospherics/pipe/simple/scrubbers/hidden/layer4{
	dir = 9
	},
/turf/open/floor/plasteel/dark,
/area/ship/bridge)
"JJ" = (
/obj/machinery/door/poddoor{
	dir = 4;
	id = "loadback"
	},
/obj/structure/cable{
	icon_state = "1-2"
	},
/turf/open/floor/plasteel/mono,
/area/ship/cargo)
"Ka" = (
/turf/template_noop,
/area/template_noop)
"KF" = (
/turf/closed/wall/r_wall/yesdiag,
/area/ship/crew)
"Ly" = (
/obj/machinery/light/directional/east,
/obj/machinery/atmospherics/pipe/simple/scrubbers/hidden/layer4,
/obj/structure/cable{
	icon_state = "1-8"
	},
/obj/structure/table,
/obj/effect/spawner/lootdrop/donkpockets{
	pixel_x = -5;
	pixel_y = 18
	},
/obj/effect/spawner/lootdrop/donkpockets{
	pixel_x = 5;
	pixel_y = 17
	},
/obj/machinery/microwave{
	pixel_y = 6
	},
/turf/open/floor/plasteel/grimy,
/area/ship/crew)
"Mb" = (
/obj/structure/cable{
	icon_state = "2-9"
	},
/obj/structure/cable{
	icon_state = "4-9"
	},
/obj/structure/chair/comfy/shuttle{
	dir = 4
	},
/obj/machinery/atmospherics/pipe/simple/supply/hidden/layer2{
	dir = 9
	},
/turf/open/floor/plasteel/grimy,
/area/ship/crew)
"Ms" = (
/obj/structure/cable{
	icon_state = "6-8"
	},
/obj/machinery/light/floor,
/obj/machinery/advanced_airlock_controller{
	pixel_y = -17
	},
/turf/open/floor/plasteel/patterned,
/area/ship/engineering/engines/port)
"Nb" = (
/obj/effect/turf_decal/industrial/warning{
	dir = 8
	},
/turf/open/floor/plasteel/mono,
/area/ship/cargo)
"Nq" = (
/obj/machinery/airalarm/directional/north,
/obj/machinery/atmospherics/pipe/simple/supply/hidden/layer2{
	dir = 10
	},
/turf/open/floor/plasteel/dark,
/area/ship/bridge)
"Nr" = (
/obj/machinery/door/poddoor{
	dir = 4;
	id = "loadback"
	},
/obj/structure/cable{
	icon_state = "0-2"
	},
/obj/machinery/power/shieldwallgen/atmos{
	id = "loadfield";
	anchored = 1
	},
/turf/open/floor/plasteel/mono,
/area/ship/cargo)
"NO" = (
/obj/machinery/atmospherics/pipe/layer_manifold,
/obj/effect/mapping_helpers/airlock/locked,
/obj/effect/turf_decal/industrial/warning/fulltile,
/obj/docking_port/mobile{
	dir = 8;
	preferred_direction = 4
	},
/obj/machinery/door/airlock/external,
/turf/open/floor/plasteel/dark,
/area/ship/engineering/engines/port)
"Ol" = (
/obj/structure/grille,
/obj/structure/window/reinforced/fulltile,
/obj/machinery/door/poddoor{
	id = "truckwindows";
	dir = 4
	},
/turf/open/floor/plating,
/area/ship/bridge)
"OI" = (
/turf/closed/wall/r_wall,
/area/ship/bridge)
"Pf" = (
/obj/structure/cable{
	icon_state = "4-8"
	},
/obj/machinery/airalarm/directional/south,
/turf/open/floor/plasteel/mono,
/area/ship/cargo)
"QZ" = (
/obj/structure/closet/emcloset/wall/directional/east,
/obj/machinery/atmospherics/pipe/simple/scrubbers/hidden/layer4,
/obj/machinery/atmospherics/components/binary/dp_vent_pump/high_volume/layer2,
/turf/open/floor/plasteel/patterned,
/area/ship/engineering/engines/port)
"Rr" = (
/obj/machinery/airalarm/directional/west,
/obj/machinery/power/smes{
	charge = 1.5e+006
	},
/obj/structure/cable{
	icon_state = "0-6"
	},
/turf/open/floor/plasteel/grimy,
/area/ship/crew)
"RZ" = (
/obj/structure/sign/warning/docking,
/turf/closed/wall/r_wall,
/area/ship/engineering/engines/port)
"Sd" = (
/obj/structure/closet/firecloset/wall/directional/east,
/obj/machinery/atmospherics/pipe/simple/supply/hidden/layer2{
	dir = 9
	},
/obj/machinery/atmospherics/pipe/simple/scrubbers/hidden/layer4,
/obj/structure/cable{
	icon_state = "1-2"
	},
/turf/open/floor/plasteel/grimy,
/area/ship/crew)
"TA" = (
/turf/closed/wall/r_wall,
/area/ship/cargo)
"Xt" = (
/obj/machinery/atmospherics/pipe/simple/scrubbers/hidden/layer4{
	dir = 4
	},
/obj/structure/cable{
	icon_state = "1-4"
	},
/obj/structure/cable{
	icon_state = "1-8"
	},
/obj/machinery/atmospherics/components/unary/vent_pump/high_volume/on/layer2{
	dir = 8
	},
/turf/open/floor/plasteel/grimy,
/area/ship/crew)
"Xx" = (
/obj/machinery/atmospherics/pipe/simple/supply/hidden/layer2{
	dir = 8
	},
/obj/machinery/door/airlock/mining{
	dir = 8;
	name = "Cargo Bay"
	},
/obj/structure/cable{
	icon_state = "4-8"
	},
/obj/machinery/atmospherics/pipe/simple/scrubbers/hidden/layer4{
	dir = 4
	},
/turf/open/floor/plasteel/mono,
/area/ship/cargo)
"YC" = (
/obj/machinery/computer/cargo/retro{
	dir = 8
	},
/turf/open/floor/plasteel/telecomms_floor,
/area/ship/bridge)
"ZN" = (
/obj/machinery/computer/helm/retro{
	dir = 8
	},
/turf/open/floor/plasteel/telecomms_floor,
/area/ship/bridge)
"ZZ" = (
/obj/machinery/light/directional/south,
/turf/open/floor/plating,
/area/ship/crew)

(1,1,1) = {"
Ka
Ka
Ka
Ka
Ka
Ka
Ka
Ka
Ka
Ka
Ka
"}
(2,1,1) = {"
Ka
Ka
Ka
FT
Nr
JJ
JJ
kD
FT
Ka
Ka
"}
(3,1,1) = {"
Ka
Ka
Ka
TA
vV
Nb
Nb
Jd
TA
Ka
Ka
"}
(4,1,1) = {"
Ka
Ka
Ka
TA
HJ
cs
cs
Cc
TA
Ka
Ka
"}
(5,1,1) = {"
Ka
Ka
Ka
TA
cs
cs
cs
uK
TA
Ka
Ka
"}
(6,1,1) = {"
Ka
Ka
Ka
TA
cs
cs
cs
Pf
TA
Ka
Ka
"}
(7,1,1) = {"
Ka
Ka
Ka
TA
HJ
cs
cs
Cc
TA
Ka
Ka
"}
(8,1,1) = {"
Ka
Ka
Ka
TA
cs
lI
cs
dT
TA
Ka
Ka
"}
(9,1,1) = {"
Ka
xa
vR
TA
EJ
sf
dC
pP
TA
lq
KF
"}
(10,1,1) = {"
Ka
lS
Bm
TA
qN
qN
qN
Xx
TA
yL
kB
"}
(11,1,1) = {"
Ka
RZ
yc
lS
xA
Rr
no
fb
yK
gF
kB
"}
(12,1,1) = {"
Ka
GV
Ms
lS
rP
mX
Mb
Xt
eZ
ZZ
kB
"}
(13,1,1) = {"
fi
NO
QZ
vk
ky
Sd
Ly
Iu
vE
aC
kB
"}
(14,1,1) = {"
Ka
mp
lS
lS
sE
kB
kB
FE
kB
kB
KF
"}
(15,1,1) = {"
Ka
Ka
jJ
OI
Nq
em
na
JE
OI
jJ
Ka
"}
(16,1,1) = {"
Ka
Ka
Ka
Ol
Ol
ZN
YC
kC
Cq
Ka
Ka
"}
(17,1,1) = {"
Ka
Ka
Ka
Ka
kC
kC
kC
qq
Ka
Ka
Ka
"}
(18,1,1) = {"
Ka
Ka
Ka
Ka
Ka
Ka
Ka
Ka
Ka
Ka
Ka
"}
(19,1,1) = {"
Ka
Ka
Ka
Ka
Ka
Ka
Ka
Ka
Ka
Ka
Ka
"}
(20,1,1) = {"
Ka
Ka
Ka
Ka
Ka
Ka
Ka
Ka
Ka
Ka
Ka
"}
